W......................................
WR.....................................
W.RPP.....PP...........................
WR...P..P..............................
WDR...P.P.P............................
WDDRPPPPPPPPPPPPPPPPPPPPPPPPPPPPPPPPPPP
DDDDDDDDDDDDDDDDDDDDDDDDDDDDDDDDDDDDDDD
