W........................................
W........................................
W........................................
WL.......................................
W.LPP.......PP...........................
WL...P....P..............................
WDL...P.P.P.P............................
WDDLPPPPPPPPPPPPPPPPPPPPPPPPPPPPPPPPPPPPP
DDDDDDDDDDDDDDDDDDDDDDDDDDDDDDDDDDDDDDDDD
