W.......................................W
W.......................................W
W.......................................W
WL......................................W
W.LPP.......PP..........................W
WL...P....P.....    .PPPGPPPGPPPPPP.....W
WDL...P.P.P.....    ....P.P.P.PPPPPPPPPPW
WDDLPPPPPPPPPPPPPPPPPPPPPPPPPPPPWWWWWWWWW
DDDDDDDDDDDDDDDDDDDDDDDDDDDDDDDDDDDDDDDDD
