W.........................DDD
W.........................DDD
W............................
W..PBPBPBP..PBPBPPPBPBPPPPPPP
WP.........P.............WDDD
W..P...........PPPP......WDDD
WP..................P....WDDD
W..P..........PP......P..WDDD
W....P.....P.......PPPPPPWDDD
W..PPPPPPP.....PPPPWDDDDDDDDD
WP........PPPPPWDDDDDDDDDDDDD
W..P....P.WDDDDDDDDDDDDDDDDDD
WP....P...WDDDDDDDDDDDDDDDDDD
WPPPPPPPPPWDDDDDDDDDDDDDDDDDD
DDDDDDDDDDDDDDDDDDDDDDDDDDDDD
DDDDDDDDDDDDDDDDDDDDDDDDDDDDD
