...................................................................................................
...................................................................................................
...................................................................................................
PPBBPPPPGGPPBBPPPGGPPPPGGPPPPPPPPP............PPPPPPPPPPPPPPPPPPPPPPPPPPPPPPPPPPPPPPPPPPPPPPPPPPPPP
...................................................................................................
...................................PPPPPP..........................................................
PPPPPPPPPPPPPPPPPPPPPPPPPPPPPPPPPPPPPPPPPPPPPPPPPPPPPPPPPPPPPPPPPPPPPPPPPPPPPPPPPPPPPPPPPPPPPPPPPPP
