W.........................DDD
W.........................DDD
W.........................DDD
W..PPPPPPP..PPPPPPPPPPPPPPPPP
WP.........P.............WDDD
W..P..........PPPPP......WDDD
WP..................P....WDDD
W..P..........PP......P..WDDD
W....P.....P.......PPPPPPWDDD
W..PPPPPPP.....PPPPWDDDDDDDDD
WP........PPPPPWDDDDDDDDDDDDD
W..P....P.WDDDDDDDDDDDDDDDDDD
WP....P...WDDDDDDDDDDDDDDDDDD
WPPPPPPPPPWDDDDDDDDDDDDDDDDDD
DDDDDDDDDDDDDDDDDDDDDDDDDDDDD
DDDDDDDDDDDDDDDDDDDDDDDDDDDDD
