W.....................................................W
W.....................................................W
W.....................................................W
WPBBPPGGPPBBPPGGPPPGGPPPPP....PPPPPPPPPPPPPPPPPPPPPPPPW
WPPPPPPPPPPPPPPPPPPPPPPPPPPPPPPPPPPPPPPPPPPPPPPPPPPPPPW
DDDDDDDDDDDDDDDDDDDDDDDDDDDDDDDDDDDDDDDDDDDDDDDDDDDDDDD
